NO ./path_to_the_north_texture
SO ./path_to_the_south_texture
WE ./path_to_the_west_texture
EA ./path_to_the_east_texture

F 255,2,0
C 255,100,0

111111111111111111111111111111111
10000000001100000000000010111111
1011000001110000000000001111111111111111
10010000000000000000000001
1111101100000111000000000000001  
100000000011000001110111111111111
11110111111111011100000010001   
11110111111111011101010010001
11000000110101011100000010001
10000000000000001100000010001
100000000000001101010010001
1000001110101011111011110N0111
1111011111110101101111010001
111111111111111 1111 111111111
