11111111111111111111111111111111
10000000001100000000000010000001
10110000011100000000000010000001
10010000000000000000000010000001
11111111011000001110000000000001
10000000001100000111011111111111
11110111111111011100000010001111
11110111111111011101010010001111
11000000110101011100000010001111
10000000000000001100000010001111
10000000000000001101010010001111
11000001110101011111011110N01111
11110111111101011101111010001111
11111111111111111111111111111111
11110001111111110001111110001111
11110001111111110001111110001111
11110001111111110001111110001111
11110001111111110001111110001111
11110001111111110001111110001111
11110001111111110001111110001111
11110001111111110001111110001111
11110001111111110001111110001111
11110001111111110001111110001111
11111111111111111111111111111111
