11111111111111111111111111111111
10000000001100000000000010000001
10110000011100000000000010000001
10010000000000000000000010000001
11111111011000001110000000000001
10000000001100000111011111001111
11110111111111011100000010001
11110111111111011101010010001
11000000110101011100000010001
10000000000000001100000010001
100000000000000011010100100011
11000001110101011111011110N011
111101111111010111011110100011
11111111111111111111111111111111
