11111111111111111111111111111111
10000000001100000000000010000001
10110000011100000000000010000001
10010000000000000000000010000001
11111111011000001110000000000001
10000000001100N00111011111001111
11110111111111011100000010001
11110111111111011101010010001
11000000110101011100000010001
10000000000000001100000010001
10000000000000001101010010011
110000011101010111110111100011
111101111111010111011110100011
11111111111111111111111111111111
